0 0 0 0 0 0 0 0 0 0 0 0 0 0 0 0 0 0 0 0 0 0 0 0 0 0 0 0 0 0 0 0
0 0 0 0 0 0 0 0 0 0 0 0 0 0 0 0 0 0 0 0 0 0 0 0 0 0 0 0 0 0 0 0
0 0 0 0 0 0 0 0 0 0 0 0 0 0 0 0 0 0 0 0 0 0 0 0 0 0 0 0 0 0 0 0
0 0 0 0 0 0 0 14 63 63 163 0 0 0 0 0 0 0 0 0 0 0 0 0 0 0 0 0 0 0 0 0
0 0 0 0 0 0 0 0 0 0 0 0 0 0 0 0 0 0 0 0 0 0 0 0 0 0 0 0 0 0 0 0
105 105 105 105 135 0 0 0 0 0 0 0 0 0 0 0 0 0 0 0 0 0 0 0 0 0 0 0 0 0 0 0
96 96 96 96 36 135 0 0 0 0 0 0 125 105 105 105 105 105 135 0 0 0 0 0 0 0 0 0 0 0 0 0
96 96 96 96 96 36 105 105 105 105 105 105 26 96 96 96 96 96 36 0 0 0 105 105 105 105 105 105 105 105 105 105
96 96 96 96 96 96 96 96 96 96 96 96 96 96 96 96 96 96 96 0 0 0 96 96 96 96 96 96 96 96 96 96
